8 8
1  1  1  1  6  1  1  1
1  0  0  1  0  0  0  7
1  1  0  1  0  1  1  1
6  0  0  0  0  0  0  3
1  8  8  0  8  0  8  1
2  2  0  0  8  8  7  1
3  0  0  0  0  0  0  5
2  2  2  2  7  4  4  4
